Rollover Text	Right-Click Text																						
"Note: Do not change the headings in this file, they are used to detect problems"																							
Main Menu																							
	"{Нова гра}

Почати нову гру."																						
	"{Завантажити гру}

Завантажити збережену гру."																						
	"{Рекорди}

Переглянути легендарних Героїв Меча та Магії."																						
	"{Творці}

Переглянути творців гри."																						
	"{Вихід}

Вийти в Windows."																						
																							
New Game	New Game																						
	"{Одиночний сценарій}

Грати в одиночний сценарій."																						
	"{Кампанія}

Грати в кампанію."																						
	"{Мультиплеєр}

Грати в мультиплеєрний сценарій."																						
	"{Навчання}

Зіграти в навчальний сценарій, де показані основи гри Герої III."																						
	"{Назад}

Повернутися на попередній екран."																						
																							
Single Scenario Selection	Single Scenario Selection																						
																							
SCENARIO_BACKGROUND 	Виберіть сценарій																						
ADVANCED_BACKGROUND 	Додаткові настройки																						
Background for random map menu	Настроїти і створити випадкову карту																						
SCENARIO_NAME 	Ім'я сценарію																						
Description Title	Показує опис сценарію																						
Description text	Показує опис сценарію																						
EASY 	"{Легкий рівень}

Гравець починає гру зі значною перевагою в ресурсах, а комп'ютер грає погано."																						
NORMAL 	"{Нормальний рівень}

Гравець починає гру з невеликою перевагою в ресурсах, а комп'ютер грає досить добре."																						
HARD 	"{Важкий рівень}

Гравець і комп'ютер починають гру з однаковою кількістю ресурсів, а комп'ютер грає так добре, як може."																						
EXPERT 	"{Надважкий рівень}

Гравець починає гру з меншою кількістю ресурсів, а комп'ютер грає на найвищому рівні."																						
IMPOSSIBLE 	"{Неможливий рівень}

Гравець починає гру без ресурсів, а комп'ютер грає на найвищому рівні."																						
ALLY_FLAG1 	Це ваш колір																						
ALLY_FLAG2 	Це колір ваших союзників																						
ALLY_FLAG3 	Це колір ваших союзників																						
ALLY_FLAG4 	Це колір ваших союзників
ALLY_FLAG5 	Це колір ваших союзників
ALLY_FLAG6 	Це колір ваших союзників
ALLY_FLAG7 	Це колір ваших союзників
ALLY_FLAG8 	Це колір ваших союзників
ENEMY_FLAG1 	Це колір ваших ворогів
ENEMY_FLAG2 	Це колір ваших ворогів
ENEMY_FLAG3 	Це колір ваших ворогів
ENEMY_FLAG4 	Це колір ваших ворогів
ENEMY_FLAG5 	Це колір ваших ворогів
ENEMY_FLAG6 	Це колір ваших ворогів
ENEMY_FLAG7 	Це колір ваших ворогів
ENEMY_FLAG8 	Це колір ваших ворогів
SCENARIO_OPTIONS 	Показати/сховати список сценаріїв.
ADVANCED_OPTIONS 	Показати/сховати додаткові опції.
random map button	Грати у випадково створену карту.
CHAT_DESC 	Перемикатись з опису сценарію до вікна чату.
MAP_DIFFICULTY 	Тут ви маєте можливість змінити рівень складності сценарію.
RATING 	Показує загальний рівень складності, що залежить від налаштувань мапи і гравця.
MAP_SIZE 	"Рівень складності карти може бути легким, нормальним, важким, надважким і неможливим."
VICTORY_CONDITION 	Умови перемоги для поточного сценарію.
LOSS_CONDITION 	Умови поразки для поточного сценарію.
SMALL_FILTER 	Показати всі маленькі мапи.
MEDIUM_FILTER 	Показати всі середні мапи.
LARGE_FILTER 	Показати всі великі мапи.
EXTRALARGE_FILTER 	Показати всі дуже великі мапи.
ALL_FILTER 	Показати всі мапи.
SCENARIO_NAME_1 	SCENARIO_NAME_1 
SCENARIO_NAME_2 	SCENARIO_NAME_2 
SCENARIO_NAME_3 	SCENARIO_NAME_3 
SCENARIO_NAME_4 	SCENARIO_NAME_4 
SCENARIO_NAME_5 	SCENARIO_NAME_5 
SCENARIO_NAME_6 	SCENARIO_NAME_6 
SCENARIO_NAME_7 	SCENARIO_NAME_7 
SCENARIO_NAME_8 	SCENARIO_NAME_8 
SCENARIO_NAME_9 	SCENARIO_NAME_9 
SCENARIO_NAME_10 	SCENARIO_NAME_10 
SCENARIO_NAME_11 	SCENARIO_NAME_11 
SCENARIO_NAME_12 	SCENARIO_NAME_12 
SCENARIO_NAME_13 	SCENARIO_NAME_13 
SCENARIO_NAME_14 	SCENARIO_NAME_14 
SCENARIO_NAME_15 	SCENARIO_NAME_15 
SCENARIO_NAME_16 	SCENARIO_NAME_16 
SCENARIO_NAME_17 	SCENARIO_NAME_17 
SCENARIO_NAME_18 	SCENARIO_NAME_18 
ENTRY_SCENARIO_NAME_1 	ENTRY_SCENARIO_NAME_1 
ENTRY_SCENARIO_NAME_2 	ENTRY_SCENARIO_NAME_2 
ENTRY_SCENARIO_NAME_3 	ENTRY_SCENARIO_NAME_3 
ENTRY_SCENARIO_NAME_4 	ENTRY_SCENARIO_NAME_4 
ENTRY_SCENARIO_NAME_5 	ENTRY_SCENARIO_NAME_5 
ENTRY_SCENARIO_NAME_6 	ENTRY_SCENARIO_NAME_6 
ENTRY_SCENARIO_NAME_7 	ENTRY_SCENARIO_NAME_7 
ENTRY_SCENARIO_NAME_8 	ENTRY_SCENARIO_NAME_8 
ENTRY_SCENARIO_NAME_9 	ENTRY_SCENARIO_NAME_9 
ENTRY_SCENARIO_NAME_10 	ENTRY_SCENARIO_NAME_10 
ENTRY_SCENARIO_NAME_11 	ENTRY_SCENARIO_NAME_11 
ENTRY_SCENARIO_NAME_12 	ENTRY_SCENARIO_NAME_12 
ENTRY_SCENARIO_NAME_13 	ENTRY_SCENARIO_NAME_13 
ENTRY_SCENARIO_NAME_14 	ENTRY_SCENARIO_NAME_14 
ENTRY_SCENARIO_NAME_15 	ENTRY_SCENARIO_NAME_15 
ENTRY_SCENARIO_NAME_16 	ENTRY_SCENARIO_NAME_16 
ENTRY_SCENARIO_NAME_17 	ENTRY_SCENARIO_NAME_17 
ENTRY_SCENARIO_NAME_18 	ENTRY_SCENARIO_NAME_18 
TURN_DURATION 	Тривалість ходу
CHAT_TEXT 	Повідомлення чату						
CHAT_ENTRY 	CHAT_ENTRY 						
CHAT_PLUG 	CHAT_PLUG 						
CHAT_PLAYER 	Гравці						
"CHAT_PLAYER_SLIDER,"	"CHAT_PLAYER_SLIDER,"						
ROLLOVER 	ROLLOVER 						
NEXT 	Зберегти поточну вибрану гру.						
BEGIN 	Почати обраний сценарій.						
BACK 	Назад						
SSEXIT 	"Закрити це вікно
(без будь-якої дії)"						
WHICHMAP 	"Поточний розмір мапи
(маленький, середній, великий і дуже великий)."						
SORT_NUMBER 	Сортувати мапи за кількістю гравців.						
SORT_SIZE 	Сортувати мапи за розміром.						
k_sort_version	Сортувати мапи за версією.						
SORT_ALPHA 	Сортувати мапи за алфавітом.						
SORT_VICTORY 	Сортувати мапи за умовами перемоги.						
SORT_LOSS 	Сортувати мапи за умовами поразки.
BRIEFING 	BRIEFING 
SSHERO 	SSHERO 
GOLDPIC 	GOLDPIC 
HUMAN_CPU1 	"""Людина чи комп'ютер"" означає, що під цим кольором може грати як людина, так і комп'ютер.  ""Тільки комп'ютер"" означає, що лише комп'ютер може грати під цим кольором."
HUMAN_CPU2 	"""Людина чи комп'ютер"" означає, що під цим кольором може грати як людина, так і комп'ютер.  ""Тільки комп'ютер"" означає, що лише комп'ютер може грати під цим кольором."
HUMAN_CPU3 	"""Людина чи комп'ютер"" означає, що під цим кольором може грати як людина, так і комп'ютер.  ""Тільки комп'ютер"" означає, що лише комп'ютер може грати під цим кольором."
HUMAN_CPU4 	"""Людина чи комп'ютер"" означає, що під цим кольором може грати як людина, так і комп'ютер.  ""Тільки комп'ютер"" означає, що лише комп'ютер може грати під цим кольором."
HUMAN_CPU5 	"""Людина чи комп'ютер"" означає, що під цим кольором може грати як людина, так і комп'ютер.  ""Тільки комп'ютер"" означає, що лише комп'ютер може грати під цим кольором."
HUMAN_CPU6 	"""Людина чи комп'ютер"" означає, що під цим кольором може грати як людина, так і комп'ютер.  ""Тільки комп'ютер"" означає, що лише комп'ютер може грати під цим кольором."
HUMAN_CPU7 	"""Людина чи комп'ютер"" означає, що під цим кольором може грати як людина, так і комп'ютер.  ""Тільки комп'ютер"" означає, що лише комп'ютер може грати під цим кольором."
HUMAN_CPU8 	"""Людина чи комп'ютер"" означає, що під цим кольором може грати як людина, так і комп'ютер.  ""Тільки комп'ютер"" означає, що лише комп'ютер може грати під цим кольором."
HANDICAP1 	Дозволяє вам надати гандикап обраному гравцю, зменшивши початкову кількість його ресурсів.
HANDICAP2 	Дозволяє вам надати гандикап обраному гравцю, зменшивши початкову кількість його ресурсів.
HANDICAP3 	Дозволяє вам надати гандикап обраному гравцю, зменшивши початкову кількість його ресурсів.
HANDICAP4 	Дозволяє вам надати гандикап обраному гравцю, зменшивши початкову кількість його ресурсів.
HANDICAP5 	Дозволяє вам надати гандикап обраному гравцю, зменшивши початкову кількість його ресурсів.
HANDICAP6 	Дозволяє вам надати гандикап обраному гравцю, зменшивши початкову кількість його ресурсів.
HANDICAP7 	Дозволяє вам надати гандикап обраному гравцю, зменшивши початкову кількість його ресурсів.
HANDICAP8 	Дозволяє вам надати гандикап обраному гравцю, зменшивши початкову кількість його ресурсів.
TOWN_LEFT1 	Дозволяє вам вибрати початковий тип міста.
TOWN_LEFT2 	Дозволяє вам вибрати початковий тип міста.
TOWN_LEFT3 	Дозволяє вам вибрати початковий тип міста.
TOWN_LEFT4 	Дозволяє вам вибрати початковий тип міста.
TOWN_LEFT5 	Дозволяє вам вибрати початковий тип міста.
TOWN_LEFT6 	Дозволяє вам вибрати початковий тип міста.
TOWN_LEFT7 	Дозволяє вам вибрати початковий тип міста.
TOWN_LEFT8 	Дозволяє вам вибрати початковий тип міста.
TOWN_RITE1 	Дозволяє вам вибрати початковий тип міста.
TOWN_RITE2 	Дозволяє вам вибрати початковий тип міста.
TOWN_RITE3 	Дозволяє вам вибрати початковий тип міста.
TOWN_RITE4 	Дозволяє вам вибрати початковий тип міста.
TOWN_RITE5 	Дозволяє вам вибрати початковий тип міста.
TOWN_RITE6 	Дозволяє вам вибрати початковий тип міста.
TOWN_RITE7 	Дозволяє вам вибрати початковий тип міста.
TOWN_RITE8 	Дозволяє вам вибрати початковий тип міста.
HERO_LEFT1 	Дозволяє вам вибрати початкового героя, базуючись на типі міста.
HERO_LEFT2 	Дозволяє вам вибрати початкового героя, базуючись на типі міста.
HERO_LEFT3 	Дозволяє вам вибрати початкового героя, базуючись на типі міста.
HERO_LEFT4 	Дозволяє вам вибрати початкового героя, базуючись на типі міста.
HERO_LEFT5 	Дозволяє вам вибрати початкового героя, базуючись на типі міста.
HERO_LEFT6 	Дозволяє вам вибрати початкового героя, базуючись на типі міста.
HERO_LEFT7 	Дозволяє вам вибрати початкового героя, базуючись на типі міста.
HERO_LEFT8 	Дозволяє вам вибрати початкового героя, базуючись на типі міста.
HERO_RITE1 	Дозволяє вам вибрати початкового героя, базуючись на типі міста.
HERO_RITE2 	Дозволяє вам вибрати початкового героя, базуючись на типі міста.
HERO_RITE3 	Дозволяє вам вибрати початкового героя, базуючись на типі міста.
HERO_RITE4 	Дозволяє вам вибрати початкового героя, базуючись на типі міста.
HERO_RITE5 	Дозволяє вам вибрати початкового героя, базуючись на типі міста.
HERO_RITE6 	Дозволяє вам вибрати початкового героя, базуючись на типі міста.
HERO_RITE7 	Дозволяє вам вибрати початкового героя, базуючись на типі міста.
HERO_RITE8 	Дозволяє вам вибрати початкового героя, базуючись на типі міста.
RES_LEFT1 	Дозволяє вам обрати початковий бонус для вашого героя.
RES_LEFT2 	Дозволяє вам обрати початковий бонус для вашого героя.
RES_LEFT3 	Дозволяє вам обрати початковий бонус для вашого героя.
RES_LEFT4 	Дозволяє вам обрати початковий бонус для вашого героя.
RES_LEFT5 	Дозволяє вам обрати початковий бонус для вашого героя.
RES_LEFT6 	Дозволяє вам обрати початковий бонус для вашого героя.
RES_LEFT7 	Дозволяє вам обрати початковий бонус для вашого героя.
RES_LEFT8 	Дозволяє вам обрати початковий бонус для вашого героя.
RES_RITE1 	Дозволяє вам обрати початковий бонус для вашого героя.
RES_RITE2 	Дозволяє вам обрати початковий бонус для вашого героя.
RES_RITE3 	Дозволяє вам обрати початковий бонус для вашого героя.
RES_RITE4 	Дозволяє вам обрати початковий бонус для вашого героя.
RES_RITE5 	Дозволяє вам обрати початковий бонус для вашого героя.
RES_RITE6 	Дозволяє вам обрати початковий бонус для вашого героя.
RES_RITE7 	Дозволяє вам обрати початковий бонус для вашого героя.
RES_RITE8 	Дозволяє вам обрати початковий бонус для вашого героя.
HERO_SETTING_1 	Натисніть тут, щоб грати під цим кольором.
HERO_SETTING_2 	Натисніть тут, щоб грати під цим кольором.
HERO_SETTING_3 	Натисніть тут, щоб грати під цим кольором.
HERO_SETTING_4 	Натисніть тут, щоб грати під цим кольором.
HERO_SETTING_5 	Натисніть тут, щоб грати під цим кольором.
HERO_SETTING_6 	Натисніть тут, щоб грати під цим кольором.
HERO_SETTING_7 	Натисніть тут, щоб грати під цим кольором.
HERO_SETTING_8 	Натисніть тут, щоб грати під цим кольором.
TOWN_SETTING_1 	TOWN_SETTING_1 
TOWN_SETTING_2 	TOWN_SETTING_2 
TOWN_SETTING_3 	TOWN_SETTING_3 
TOWN_SETTING_4 	TOWN_SETTING_4 
TOWN_SETTING_5 	TOWN_SETTING_5 	
TOWN_SETTING_6 	TOWN_SETTING_6 	
TOWN_SETTING_7 	TOWN_SETTING_7 	
TOWN_SETTING_8 	TOWN_SETTING_8 	
"const_create_map,"		
"const_map_size_label,"	Виберіть розмір мапи.	
"const_small_map,"	Створити маленьку мапу.	
"const_medium_map,"	Створити середню мапу.	
"const_large_map,"	Створити велику мапу.	
"const_huge_map,"	Створити дуже велику мапу.	
"const_map_levels,"	Виберіть одно- чи дворівневу мапу.	
"const_human_positions_label,"	Виберіть кількість позицій для гравців-людей.	
"const_1_human,"	Створити 1 гравця-людину.	
"const_2_humans,"	Створити 2 гравців-людей.	
"const_3_humans,"	Створити 3 гравців-людей.	
"const_4_humans,"	Створити 4 гравців-людей.	
"const_5_humans,"	Створити 5 гравців-людей.	
"const_6_humans,"	Створити 6 гравців-людей.	
"const_7_humans,"	Створити 7 гравців-людей.	
"const_8_humans,"	Створити 8 гравців-людей.	
"const_random_humans,"	Створити 1-8 гравців-людей.	
"const_human_teams_label,"	Виберіть кількість команд гравців-людей.	
"const_no_human_teams,"	Без команд.	
"const_1_human_team,"	Створити 1 команду	
"const_2_human_teams,"	Створити 2 команди.	
"const_3_human_teams,"	Створити 3 команди.	
"const_4_human_teams,"	Створити 4 команди.	
"const_5_human_teams,"	Створити 5 команд.	
"const_6_human_teams,"	Створити 6 команд.	
"const_7_human_teams,"	Створити 7 команд.	
"const_random_human_teams,"	Створити випадкову кількість команд.	
"const_computer_positions_label,"	Вибрати кількість позицій для комп'ютера	
"const_no_computers,"	Створити без комп'ютера.	
"const_1_computer,"	Створити 1 позицію для комп'ютера.	
"const_2_computers,"	Створити 2 позиції для комп'ютера.	
"const_3_computers,"	Створити 3 позиції для комп'ютера.	
"const_4_computers,"	Створити 4 позиції для комп'ютера.	
"const_5_computers,"	Створити 5 позицій для комп'ютера.	
"const_6_computers,"	Створити 6 позицій для комп'ютера.	
"const_7_computers,"	Створити 7 позицій для комп'ютера.	
"const_random_computers,"	Створити випадкову кількість позицій для комп'ютера.	
"const_computer_teams_label,"	Вибрати кількість команд комп'ютера.	
"const_no_computer_teams,"	Без команд комп'ютера.	
"const_1_computer_team,"	Створити 1 команду комп'ютера.	
"const_2_computer_teams,"	Створити 2 команди комп'ютера.	
"const_3_computer_teams,"	Створити 3 команди комп'ютера.	
"const_4_computer_teams,"	Створити 4 команди комп'ютера.	
"const_5_computer_teams,"	Створити 5 команд комп'ютера.	
"const_6_computer_teams,"	Створити 6 команд комп'ютера.	
"const_random_computer_teams,"	Створити випадкову кількість команд комп'ютера.	
"const_water_label,"	Вибрати кількість води на мапі.	
"const_no_water,"	Мінімум або відсутність води.	
"const_normal_water,"	Створити континент оточений водою.	
"const_islands,"	Створити багато земель, оточених водою.	
"const_random_water,"	Включити випадкову кількість води.	
"const_monster_strength_label,"	Вибрати відносну силу вартових монстрів.	
"const_weak_monsters,"	Зробити монстрів слабшими, ніж нормальні.	
"const_normal_monsters,"	Вартові нормальної сили.	
"const_strong_monsters,"	Створити сильних вартових.	
"const_random_monsters,"	Обрати випадкову загальну силу вартових монстрів.	
"const_show_saved_random_maps,"	Показати нещодавно згенеровані випадкові мапи.	
SLIDER_CHATWINDOW 	Прокрутити чат	
SLIDER_FILEMENU 	Прокрутити список сценаріїв чи збережених ігор.	
SLIDER_DURATION 	Дозволяє змінити тривалість ходу гравців.	
"PLAYER_HANDICAP_HEADER_ID,"	"{Ім'я гравця / Тип гандикапу}

Кожна потенційна позиція гравця-людини позначена суміжним прапорцем.  Клацніть по ньому, щоб змінити позицію.  Ви також можете клацнути по імені гравця, щоб змінити його.

Кожен гравець може отримати гандикап клікнувши по відповідній кнопці.  Є три типи гандикапу: Без гандикапу, Помірний гандикап та Сильний гандикап.  Помірний та Сильний зменшують початкову кількість ресурсів гравця.
"																						
"TURN_DURATION_HEADER_ID,"	"{Тривалість ходу гравця}

Використовуючи слайдер, ви можете встановити тривалість ходу гравця.  Таймер враховує лише час поза боєм.  У бою таймер зупиняє відлік.

Тривалість ходу може бути 1, 2, 4, 6, 8, 10, 15, 20, 25 і 30 хвилин.
""Без обмежень"" встановлюється за замовчуванням.
"																						
"STARTING_TOWN_HEADER_ID,"	"{Початкове місто}

Кожен гравець може почати гру з містом або без.  Місто може бути: Випадкове, Замок, Твердиня, Вежа, Інферно, Некрополіс, Підземелля, Цитадель або Фортеця.

Якщо ви починаєте гру без міста, то ця опція визначає фракцію початкового героя.
"																						
"STARTING_TOWN_HEADER_W_CONFLUX_ID,"	"{Початкове місто}

Кожен гравець може почати гру з містом або без.  Місто може бути: Випадкове, Замок, Твердиня, Вежа, Інферно, Некрополіс, Підземелля, Цитадель, Фортеця або Колонія.

Якщо ви починаєте гру без міста, то ця опція визначає фракцію початкового героя.
"																						
"STARTING_HERO_HEADER_ID,"	"{Початковий герой}

Кожен гравець може почати гру з героєм або без.  Іноді ця опція може бути заблокована чи відсутня.  В іншому випадку ви можете вибрати героя.  Якщо опція вибору міста доступна, ви можете змінити клас героя і вибрати його зі списку.

Щоб побачити ім'я героя, клас і спеціалізацію, натисніть на портрет героя.
"																						
"STARTING_BONUS_HEADER_ID,"	"{Початковий бонус}

Як початковий бонус ви можете вибрати випадковий артефакт, 500-1000 золотих або 5-10 дерева і руди.
"																						
																							
Multiplayer Selection	Multiplayer Selection																						
																							
Онлайн сервіс	"{Онлайн сервіс}

Дозволяє грати через онлайн сервіс."																						
Гаряче крісло	"{Гаряче крісло}

Дозволяє кільком людям грати за одним комп'ютером."																						
IPX	"{IPX}

Дозволяє кільком людям грати через локальну мережу."																						
TCP/IP	"{TCP/IP}

Дозволяє кільком людям грати через локальну мережу або через інтернет."																						
Модем	"{Модем}

Дозволяє двом гравцям з'єднатись через модем."																						
Пряме з'єднання	"{Пряме з'єднання}

Дозволяє двом гравцям встановити пряме з'єднання."																						
Створити гру	"{Створити гру}

Дозволяє налаштувати і створити гру, до якої зможуть підключитись інші гравці."																						
Приєднатися до гри	"{Приєднатись до гри}

Показує перелік ігор, до яких ви можете приєднатись."
Пошук гри	"{Пошук гри}

Дозволяє ввести точну IP-адресу, щоб підключитися до неї."
GAMENAME 1	GAMENAME 1
GAMENAME 2	GAMENAME 2
GAMENAME 3	GAMENAME 3
GAMENAME 4	GAMENAME 4
GAMENAME 5	GAMENAME 5
GAMENAME 6	GAMENAME 6
GAMENAME 7	GAMENAME 7
GAMENAME 8	GAMENAME 8
GAMENAME 9	GAMENAME 9
GAMENAME 10	GAMENAME 10
GAMENAME 11	GAMENAME 11
GAMENAME 12	GAMENAME 12
Прокрутити	Прокрутити доступні ігри.
	
Скасувати	Повернутись у попереднє меню.																						
																							
Adventure Map Window																							
Мапа світу	"Це зменшене зображення світу.  Натиснення будь-де в цьому вікні відцентрує мапу пригод у тому місці, або ви можете перетягнути контур, щоб прокрутити мапу пригод."																						
Вікно статусу	SELECTION WINDOW																						
Огляд королівства	"{Огляд королівства}

Показує всі міста й герої вашого королівства."																						
Огляд підземного/наземного світу	"{Огляд підземного/наземного світу}

Перемикає мапу пригод між рівнями."																						
Журнал завдань	"{Журнал завдань}

Показує перелік усіх поточних завдань."																						
Приспати/розбудити героя	"{Приспати/розбудити героя}

Присипає обраного героя або пробуджує героя, що спить.  Усі герої, що сплять, будуть ігноровані кнопкою Наступний герой."																						
Пересунути героя	"{Пересунути героя}

Пересуває поточного героя обраним шляхом."																						
Накласти закляття	"{Накласти закляття}

Накласти не бойове закляття."																						
Ігрові дії	"{Ігрові дії}

Дозволяє вам розкопати Грааль, оглянути Пазл Грааля, Мапу Світу або Сценарій.  У мультиплеєрному режимі ви також можете побачити останній хід вашого опонента."																						
Опції системи	"{Опції системи}

Дозволяє оглянути і змінити поточні ігрові опції."																						
Наступний герой	"{Наступний герой}

Обирає наступного героя, який ще має очки руху.  Усі герої, що сплять, ігноруються."																						
Закінчити хід	"{Закінчити хід}

Закінчити свій хід."																						
Прокрутити список героїв	"{Прокрутити список героїв}

Прокрутити вгору список доступних героїв."																						
Прокрутити список героїв	"{Прокрутити список героїв}

Прокрутити вниз список доступних героїв."																						
Портрет героя	"{Портрет героя}

Натисніть, щоб обрати цього героя і розмістити мапу пригод там, де він.  Натисніть ще раз, щоб оглянути Екран героя."																						
Прокрутити список міст	"{Прокрутити список міст}

Прокрутити вгору список доступних міст."																						
Прокрутити список міст	"{Прокрутити список міст}

Прокрутити вниз список доступних міст."																						
Зображення міста	"{Зображення міста}

Натисніть, щоб обрати це місто і розмістити мапу пригод там, де воно.  Натисніть ще раз, щоб оглянути Екран міста."																						
Золото	Кількість золота у вашій скарбниці.																						
Деревина	Кількість доступної деревини.																						
Ртуть	Кількість доступної ртуті.																						
Руда	Кількість доступної руди.																						
Сірка	Кількість доступної сірки.																						
Кристали	Кількість доступних кристалів.																						
Самоцвіти	Кількість доступних самоцвітів.																						
Дата	"{Дата}

Поточний місяць, тиждень і день."																						
ROLLOVER	ROLLOVER																						
																							
System Options	System Options																						
Головне меню	"{Головне меню}

Завершити гру і перейти до головного меню."
Завантажити гру	"{Завантажити гру}

Завантажити збережену гру."
Зберегти гру	"{Зберегти гру}

Зберегти поточну гру."
Почати заново	"{Почати заново}

Розпочати заново поточний сценарій."
Вийти на робочий стіл	"{Вийти на робочий стіл}

Вийти з Героїв Меча та Магії III"
Повернутися	"{Повернутися до гри}

Повернутися до Мапи Пригод!"
"MUSIC_VOLUME_0_ID,"	Вимкнути музику.
"MUSIC_VOLUME_1_ID,"	Встановити гучність музики на 1.
"MUSIC_VOLUME_2_ID,"	Встановити гучність музики на 2.
"MUSIC_VOLUME_3_ID,"	Встановити гучність музики на 3.
"MUSIC_VOLUME_4_ID,"	Встановити гучність музики на 4.
"MUSIC_VOLUME_5_ID,"	Встановити гучність музики на 5.
"MUSIC_VOLUME_6_ID,"	Встановити гучність музики на 6.
"MUSIC_VOLUME_7_ID,"	Встановити гучність музики на 7.
"MUSIC_VOLUME_8_ID,"	Встановити гучність музики на 8.
"MUSIC_VOLUME_9_ID,"	Встановити гучність музики на 9.
"EFFECTS_VOLUME_0_ID,"	Вимкнути звукові ефекти.
"EFFECTS_VOLUME_1_ID,"	Встановити гучність ефектів на 1.
"EFFECTS_VOLUME_2_ID,"	Встановити гучність ефектів на 2.
"EFFECTS_VOLUME_3_ID,"	Встановити гучність ефектів на 3.
"EFFECTS_VOLUME_4_ID,"	Встановити гучність ефектів на 4.
"EFFECTS_VOLUME_5_ID,"	Встановити гучність ефектів на 5.
"EFFECTS_VOLUME_6_ID,"	Встановити гучність ефектів на 6.
"EFFECTS_VOLUME_7_ID,"	Встановити гучність ефектів на 7.
"EFFECTS_VOLUME_8_ID,"	Встановити гучність ефектів на 8.
"EFFECTS_VOLUME_9_ID,"	Встановити гучність ефектів на 9.
"MUSIC_TYPE_NONE_ID,"	"MUSIC_TYPE_NONE_ID,"
"MUSIC_TYPE_CD_ID,"	"MUSIC_TYPE_CD_ID,"
"MUSIC_TYPE_MIDI_ID,"	"MUSIC_TYPE_MIDI_ID,"
"HERO_SPEED_WALK_ID,"	"Встановити швидкість героя: хода
(повільно)."
"HERO_SPEED_CANTER_ID,"	Встановити швидкість героя: біг.
"HERO_SPEED_GALLOP_ID,"	Встановити швидкість героя: галоп.
"HERO_SPEED_JUMP_ID,"	"Встановити швидкість героя: стрибки
(без анімації — найшвидше)"
"AI_SPEED_CANTER_ID,"	"Встановити швидкість ворога: біг
(повільно)."
"AI_SPEED_GALLOP_ID,"	Встановити швидкість ворога: галоп.
"AI_SPEED_JUMP_ID,"	"Встановити швидкість ворога: стрибки
(без анімації — найшвидше)"
"AI_SPEED_NONE_ID,"	Не показувати рух ворога.
"WINDOW_SCROLL_SLOW,"	Встановити швидкість розгортання мапи: повільно.
"WINDOW_SCROLL_MEDIUM,"	Встановити швидкість розгортання мапи: нормально.
"WINDOW_SCROLL_FAST,"	Встановити швидкість розгортання мапи: швидко.
"SHOW_PATH_ID,"	"{Показувати шлях руху}

Коли вибране, показує шлях героя, не пересуваючи його."
"MOVE_REMINDER_ID,"	"{Показувати нагадувач героя}

Коли гравець має героя, у котрого ще залишились очки руху, нагадувач запитає підтвердження Кінця ходу."
"QUICK_COMBAT_ID,"	"{Швидка сутичка}

Ця опція дозволяє комп'ютеру виконувати розрахунок всіх боїв, і гравець буде бачити лише екран результату бою."
"VIDEO_SUBTITLES_ID,"	"{Субтитри}

Ця опція буде показувати субтитри в будь-якому анімаційному відео гри."
VIDEO_QUALITY_LOW	"{Низька якість відео}

Ця опція рекомендована для повільних комп'ютерів, у яких є труднощі з відтворенням відео на повному екрані."
VIDEO_QUALITY_HIGH	"{Висока якість відео}

Швидші машини можуть оперувати більшою кількістю даних, і ця опція дозволяє таким машинам показувати відео в найкращій якості."
"TOWN_OUTLINES_ID,"	"{Контури в містах}

На екрані міста кожна доступна споруда буде обведена контуром, коли курсор буде розташований на ній."
"ANIMATE_SPELLBOOK_ID,"	"{Анімація книги заклинань}

Показувати перегортання сторінок у книзі заклинань."
																							
Adventure Options																							
Показати світ	"{Показати світ}

Побачити світ з висоти пташиного польоту."																						
Подивитись пазл	"{Подивитись пазл}

Показати мату прихованих об'єктів."																						
Подивитись сценарій	"{Подивитись сценарій}

Отримати інформацію про поточний сценарій."																						
Копати	"{Копати}

Шукати Грааль у цьому місці."																						
Повторити хід опонента	"{Повторити хід опонента}

Повторити події, що відбулись протягом вашого ходу."																						
ROLLOVER	ROLLOVER																						
Гаразд	"{Гаразд}

Повернутись до мапи пригод."																						
																							
Combat Window	Combat Window																						
Здатися	"{Здатися}

Вирішити здатися ворогу.  Ваш герой мусить заплатити, щоб покинути битву, і він може бути одразу найнятий у корчмі разом з усіма військами й артефактами, які зараз у його розпорядженні."																						
Відступати	"{Відступати}

Ваш герой втече з поля бою і зможе бути одразу найнятий у корчмі разом з усіма артефактами, що зараз у його розпорядженні."																						
Опції битви	"{Опції битви}

Дозволяє оглянути чи змінити поточні опції битви."																						
Автобитва	"{Автобитва}

Дозволяє комп'ютеру самостійно провести битву для вас.  Клікніть будь-де під час автобитви, щоб взяти свої війська під контроль.  Ви зможете керувати з наступного ходу вашого загону."																						
	Текст битви з'являється в цьому вікні.																						
	Прокрутка тексту, що показується під час битви.																						
Накласти закляття	"{Накласти закляття}

Розгортає книгу заклинань вашого героя, дозволяючи йому накласти закляття."																						
Чекати	"{Чекати}

Пропустити хід цього загону і зачекати, доки всі війська матимуть можливість ходу."																						
Захищатися	"{Захищатися}

Збільшує захист загону, жертвуючи своїм ходом."																						
Наступний загін	Наступний загін																						
Закінчити тактичну фазу	"{Закінчити тактичну фазу}

Закінчити тактичну фазу та почати битву."																						
																							
Combat Options	Combat Options																						
Повернутися до гри	"{Повернутися до гри}

Вийти з опцій бою."																						
Відновити опції за замовчуванням	"{За замовчуванням}

Відновити опції битви за замовчуванням."																						
"MUSIC_VOLUME_0_ID,"	Вимкнути музику																						
"MUSIC_VOLUME_1_ID,"	Встановити гучність музики на 1																						
"MUSIC_VOLUME_2_ID,"	Встановити гучність музики на 2																						
"MUSIC_VOLUME_3_ID,"	Встановити гучність музики на 3																						
"MUSIC_VOLUME_4_ID,"	Встановити гучність музики на 4																						
"MUSIC_VOLUME_5_ID,"	Встановити гучність музики на 5																						
"MUSIC_VOLUME_6_ID,"	Встановити гучність музики на 6
"MUSIC_VOLUME_7_ID,"	Встановити гучність музики на 7
"MUSIC_VOLUME_8_ID,"	Встановити гучність музики на 8
"MUSIC_VOLUME_9_ID,"	Встановити гучність музики на 9
"EFFECTS_VOLUME_0_ID,"	Вимкнути ефекти
"EFFECTS_VOLUME_1_ID,"	Встановити гучність ефектів на 1
"EFFECTS_VOLUME_2_ID,"	Встановити гучність ефектів на 2
"EFFECTS_VOLUME_3_ID,"	Встановити гучність ефектів на 3
"EFFECTS_VOLUME_4_ID,"	Встановити гучність ефектів на 4
"EFFECTS_VOLUME_5_ID,"	Встановити гучність ефектів на 5
"EFFECTS_VOLUME_6_ID,"	Встановити гучність ефектів на 6
"EFFECTS_VOLUME_7_ID,"	Встановити гучність ефектів на 7
"EFFECTS_VOLUME_8_ID,"	Встановити гучність ефектів на 8
"EFFECTS_VOLUME_9_ID,"	Встановити гучність ефектів на 9
"MUSIC_TYPE_NONE_ID,"	"MUSIC_TYPE_NONE_ID,"
"MUSIC_TYPE_CD_ID,"	"MUSIC_TYPE_CD_ID,"
"MUSIC_TYPE_MIDI_ID,"	"MUSIC_TYPE_MIDI_ID,"
"AUTO_CREATURES_ID,"	"{Істоти}

Дозволяє керувати вашими військами комп'ютеру під час автобитви."
"AUTO_SPELLS_ID,"	"{Закляття}

Під час автобитви ваш герой буде накладати закляття."
"AUTO_CATAPULT_ID,"	"{Катапульта}

Коли ви тримаєте ворожий замок в облозі, ваші артилеристи вирішуватимуть, в яку частину укріплень цілитись.  Якщо ваша навичка Балістики достатньо висока, ви матимете можливість скеровувати постріли катапульти самостійно.

Якщо ваш герой володіє Балістикою, то ця опція даватиме контроль над катапультою комп'ютеру під час автобитви."
"AUTO_BALLISTA_ID,"	"{Баліста}

Під час битви, ваші артилеристи вирішуватимуть, в які загони цілитись.  Якщо ваша навичка Артилерії достатньо висока, ви матимете можливість скеровувати постріли балісти самостійно.

Якщо ваш герой володіє навичками Артилерії, то ця опція даватиме контроль над балістою комп'ютеру під час автобитви."
"AUTO_FIRST_AID_TENT_ID,"	"{Намет першої допомоги}

Під час бою, ваші медики вибиратимуть, кого з воїнів лікувати.  Якщо ваші навички Першої допомоги достатньо високі, ви матимете можливість керувати наметом самостійно.

Якщо ваш герой володіє навичками першої допомоги, ця опція даватиме контроль над наметом першої допомоги комп'ютеру під час автобитви."
"ANIMATION_SPEED_0_ID,"	Встановити низьку швидкість анімації.
"ANIMATION_SPEED_1_ID,"	Встановити середню швидкість анімації.
"ANIMATION_SPEED_2_ID,"	Встановити високу швидкість анімації.
"CREATURE_INFO_STATS_ID,"	"{Вся статистика}

Клік ПКМ по загону показуватиме всю статистичну інформацію про істот, включно з усіма поточними магічними ефектами."
"CREATURE_INFO_SPELLS_ID,"	"{Лише закляття}

Клік ПКМ по загону показуватиме лише поточні магічні ефекти."
"VIEW_HEX_ID,"	"{Показати сітку}

Виводить сітку на полі бою."
"MOVEMENT_SHADOW_ID,"	"{Тінь руху}

Показує на полі битви тінь, яка показує, куди зараз може рухатись загін."
"SHADOW_CURSOR_ID,"	"{Тінь курсора}

Розміщує тінь під курсором на полі битви."
"ANIMATE_SPELLBOOK_ID,"	"{Анімація книги заклинань}

Показує анімацію перегортання сторінки в книзі заклинань."
	
View Army	View Army																						
Назва істоти	Назва істоти																						
Кількість істот	Кількість істот в загоні																						
Навичка нападу	Навичка нападу																						
Навичка захисту	Навичка захисту																						
Залишок пострілів	Кількість пострілів, що залишились																						
Пошкоджень на атаку	Пошкоджень на атаку																						
Здоров'я	Здоров'я																						
Поточне здоров'я	Поточне здоров'я																						
Швидкість	Швидкість																						
Мораль	Мораль																						
Удача	Удача																						
Магічні ефекти	Магічні ефекти																						
Розпустити загін	"{Розпустити загін}

Відпускає обраний загін з вашої армії."																						
Вдосконалити загін	"{Вдосконалити загін}

Вдосконалює обраний загін."																						
Гаразд	"{Гаразд}

Повернутись у попереднє вікно."																						
																							
Spell Book	Spell Book																						
Попередня сторінка	Перегорнути на попередню сторінку.																						
Наступна сторінка	Перегорнути на наступну сторінку.																						
Закляття мапи пригод	Розгорнути розділ заклять мапи пригод.																						
Бойові закляття	Розгорнути розділ бойових заклять.																						
Магія Повітря	Розгорнути закляття магії Повітря.																						
Магія Вогню	Розгорнути закляття магії Вогню.																						
Магія Води	Розгорнути закляття магії Води.																						
Магія Землі	Розгорнути закляття магії Землі.																						
Усі закляття	Показати всі закляття.																						
Мана	Залишок очок мани героя.																						
Вихід	Закрити книгу заклинань.																						
																							
CampaignBrief	CampaignBrief																						
																							
CAMPAIGN_NAME	CAMPAIGN_NAME
CAMPAIGN_DESCRIPTION	CAMPAIGN_DESCRIPTION
MAP_NAME	MAP_NAME
MAP_DESCRIPTION	MAP_DESCRIPTION
HERO_FACE	HERO_FACE
Зміна героя	Клацніть, щоб змінити початкового героя
Зміна героя	Клацніть, щоб змінити початкового героя
Бонус: артефакт	Виберіть, щоб розпочати гру з артефактом
Бонус: золото	Виберіть, щоб розпочати гру з додатковим золотом
Бонус: ресурси	Виберіть, щоб розпочати гру з додатковими ресурсами
Спочатку	"{Спочатку}

Розпочати поточну кампанію заново"
Вступ	"{Вступ}

Подивитися вступне відео до цієї кампанії"
ALLY_FLAG1_ID	Це ваш колір.
ALLY_FLAG2_ID	Це колір ваших союзників.
ALLY_FLAG3_ID	Це колір ваших союзників.
ALLY_FLAG4_ID	Це колір ваших союзників.
ALLY_FLAG5_ID	Це колір ваших союзників.
ALLY_FLAG6_ID	Це колір ваших союзників.
ALLY_FLAG7_ID	Це колір ваших союзників.
ALLY_FLAG8_ID	Це колір ваших союзників.
ENEMY_FLAG1_ID	Це колір ваших ворогів.
ENEMY_FLAG2_ID	Це колір ваших ворогів.
ENEMY_FLAG3_ID	Це колір ваших ворогів.
ENEMY_FLAG4_ID	Це колір ваших ворогів.
ENEMY_FLAG5_ID	Це колір ваших ворогів.
ENEMY_FLAG6_ID	Це колір ваших ворогів.
ENEMY_FLAG7_ID	Це колір ваших ворогів.
ENEMY_FLAG8_ID	Це колір ваших ворогів.
WHICHMAP_ID	Це розміри мапи.
MAP_AREA_1	MAP_AREA_1
MAP_AREA_2	MAP_AREA_2
MAP_AREA_3	MAP_AREA_3
MAP_AREA_4	MAP_AREA_4
MAP_AREA_5	MAP_AREA_5
MAP_AREA_6	MAP_AREA_6
MAP_AREA_7	MAP_AREA_7
MAP_AREA_8	MAP_AREA_8
MAP_AREA_9	MAP_AREA_9
MAP_AREA_10	MAP_AREA_10
MAP_AREA_11	MAP_AREA_11
MAP_AREA_12	MAP_AREA_12
MAP_AREA_13	MAP_AREA_13
MAP_AREA_14	MAP_AREA_14
MAP_AREA_15	MAP_AREA_15
MAP_AREA_16	MAP_AREA_16
MAP_AREA_17	MAP_AREA_17
MAP_AREA_18	MAP_AREA_18
MAP_AREA_19	MAP_AREA_19
MAP_AREA_20	MAP_AREA_20																						
MAP_AREA_21	MAP_AREA_21																						
MAP_AREA_22	MAP_AREA_22																						
MAP_AREA_23	MAP_AREA_23																						
MAP_AREA_24	MAP_AREA_24																						
MAP_AREA_25	MAP_AREA_25																						
MAP_AREA_26	MAP_AREA_26																						
MAP_AREA_27	MAP_AREA_27																						
MAP_AREA_28	MAP_AREA_28																						
MAP_AREA_29	MAP_AREA_29																						
MAP_AREA_30	MAP_AREA_30																						
MAP_AREA_31	MAP_AREA_31																						
MAP_AREA_32	MAP_AREA_32																						
																							
CampaignWindow	CampaignWindow																						
																							
Нехай живе королева	Нехай живе королева		
Визволення	Визволення		
Вигода війни	Вигода війни		
Пісня для батька	Пісня для батька		
Підземелля й демони	Підземелля й демони		
Хай живе король	Хай живе король		
Сім'я невдоволення	Сім'я невдоволення		
Клинок Армагеддону	Клинок Армагеддону		
Кров дракона	Кров дракона		
Вбивця драконів	Вбивця драконів		
Фестиваль життя	Фестиваль життя		
Безрозсудний непослух	Безрозсудний непослух		
Гра з вогнем	Гра з вогнем		
Рубай і шматуй	Рубай та шматуй		
Народження варвара	Народження варвара		
Новий початок	Новий початок		
Еліксир життя	Еліксир життя																						
Сходження некроманта	Сходження некроманта																						
Проклятий альянс	Проклятий альянс																						
Спектр сили	Спектр сили																						
																							
																							
ROLLOVER	ROLLOVER																						
																							
Recruit	Recruit																						
Максимум																							
Найняти																							
Скасувати																							
																							
Multiplayer	Multiplayer																						
Прапорець	Клацніть тут, щоб увімкнути/вимкнути ім'я.																						
Введіть ім'я гравця	Введіть ім'я гравця																						
Гаразд																							
Назад																							
Введіть назву сеансу																							
Введіть пароль																							
Назва сеансу																							
Введіть IP-адресу																							
																							
Sacrifice Window	Sacrifice Window																						
Вихід (нічого не буде принесене в жертву).	Покинути вівтар.  Усі речі, що були на вівтарі, повертаються вам.																						
Поточний артефакт																							
Покласти всі артефакти з сумки на вівтар	Перетягніть речі з рюкзака героя на вівтар.																						
Покласти всі артефакти на вівтар	"Перенести всі артефакти, і одягнені і ті, що знаходяться в сумці, на вівтар."																						
Жертвопринесення воїнів	Виберіть істот для жертвопринесення.  Доступно лише для злих і нейтральних героїв.																						
Кількість істот / Кількість досвіду																							
Вибрані істоти																							
Кількість істот / Кількість досвіду																							
Кількість істот для жертвопринесення																							
Встановіть кількість істот для жертвопринесення																							
Принести в жертву максимальну кількість істот	Перенести максимальну кількість істот на вівтар.																						
Принести в жертву всіх істот з армії героя	Перенести всіх істот на вівтар, окрім одного.																						
Принести в жертву артефакт	Перейти до екрану артефактів.  Доступно лише для злих і нейтральних героїв.																						
Кількість істот / Кількість досвіду																							
Розмістіть артефакт для жертвопринесення тут																							
Кількість досвіду за артефакт																							
Принести в жертву артефакти, що лежать на вівтарі	"Принести в жертву те, що на вівтарі та отримати досвід."																						
Принести в жертву істот, що лежать на вівтарі	"Принести в жертву те, що на вівтарі та отримати досвід."																						
	Оглянути рюкзак																						
	Оглянути рюкзак																						
																							
Skeleton Transformer	Skeleton Transformer																						
Розмістити всіх істот в трансформаторі	Перенести всіх істот у трансформатор																						
Перетворити істот у трансформаторі на нежить	Перетворити істот у трансформаторі на нежить																						
Вийти	Покинути трансформатор.  Жодна істота більше не перетвориться на нежить.																						
																							
Trade Window	Trade Window																						
Торгівля																							
Максимум																							
Передати ресурси іншому гравцю																							
Купити артефакт																							
Продати істот																							
Вихід																							
																							
Give Resource Window	Give Resource Window																						
Торгівля																							
Максимум																							
Обмін ресурсів																							
Купити артефакт																							
Вихід																							
																							
Buy Artifact Window	Buy Artifact Window																						
Торгівля																							
Обмін ресурсів																							
Передати ресурси іншому гравцю																							
Продати артефакти																							
Вихід																							
																							
Sell Artifact Window	Sell Artifact Window																						
Торгівля																							
Обмін ресурсів																							
Передати ресурси іншому гравцю																							
Купити артефакти																							
Вихід																							
																							
Sell Creature Window	Sell Creature Window																						
Торгівля																							
Максимум																							
Обмін ресурсів																							
Передати ресурси іншому гравцю																							
Вихід																							
																							
University Window	University Window																						
Скасувати	Повернутись до вибору навичок																						
Покинути університет	Покинути університет																						
	Вивчити %s %s за %d золотих.																						
Not used...  filthy bug.																							
Insert all data before this line. Do not alter or delete this line.																							



																							
